Abandon - Porzucac
Abbreviate - Skracac
Abbreviation - Skrot
Abdomen - Brzuch
Abdominal - Brzuszny
Abduction - Porwanie
Ability - Zdolnosc
Ablaze - W plomieniach
Able - Zdolny
Abnormal - Nienormalny
Aboard - Na pokladzie
Abolish - Obalac, Znosic
Abort - Zaniechac
Abortion - Aborcja
About - Okolo
Above - Powyzej
Abroad - Za granica
Abrupt - Nagly
Absence - Nieobecnosc
Absent - Nieobecny
Absent - Nieobecny
Absolutely - Absolutnie
Absorb - Wchlaniac
Abstain - Wstrzymywac sie
Absurd - Absurdalny
Abuse - Naduzywanie
Abuse - Naduzywac
Accommodation - Zakwaterowanie
Accounting - Ksiegowosc
Actor - Aktor
Address - Adres
Adjective - Przymiotnik
Adult - Dorosly
Advertisement - Reklama
Affair - Sprawa
Afternoon - Popoludnie
Agatha - Agata
Age - Wiek
Agnes - Agnieszka
Agree - Zgadzac sie
Agreement - Porozumienie
Airport - Lotnisko
Alcohol - Alcohol
Alimony - Alimenty
Always - Zawsze
Amateur - Amator
American - Amerykanski
Andy - Andrzej
Angela - Aniela
Ankle - Kostka
Anna - Anna
Anniversary - Rocznica
Announce - Oglaszac
Annoy - Draznic
Annual - Doroczny
Ant - Mrowka
Antenna - Antenna
Anthem - Hymn
Anthony - Antoni
Antibiotic - Antybiotyk
Anybody - Ktokolwiek
Apartment - Apartament
Apple - Jablko
Application - Aplikacja
Appoint - Mianowac
April - Kwiecien
Aquarius - Wodnik
Aries - Baran
Army - Wojsko
Art - Sztuka
Arthur - Artur
Ass - Dupa
Assertive - Stanowczy
Attack - Atakowac
Attorney - Adwokat
Audit - Rewizja
August - Sierpien
Aunt - Ciocia
Auto - Auto
Automatic - Automatyczny
Autumn - Jesien
Available - Dostepny
Avoid - Unikac
Award - Nagroda
Awful - Straszny
Awkward - Niezreczny 
Baby - Niemowle
Babysitter - Opiekunka do dziecka
Bad - Zly
Badger - Borsuk
Badly - Zle
Bag - Torba
Bail - Kaucja
Bait - Przyneta
Bake - Piec
Bakery - Piekarnia
Ball - Pilka
Bank - Bank
Banking - Bankowosc
Barbara - Barbara
Basketball - Koszykowka
Bastard - Swinia
Bat - Nietoperz
Bath - Lazienka
Bathe - Kapac sie
Be able to do sth - Moc cos zrobic
Be afraid - Bac sie
Be born - Narodzic sie
Be in jeopardy - Byc w niebezpieczenstwie
Beautiful - Piekna
Beauty - Pieknosc
Bedroom - Sypialnia
Beef - Wolowina
Beer - Piwo
Begin - Zaczynac
Belief - Wiara
Believe - Wierzyc
Bible - Biblia
Bicycle - Rower
Bid - Oferta
Bid - Licytowac
Big - Duzy
Bilingual - Dwujezyczny
Biology - Biologia
Birth certificate - Metryka urodzenia
Birthday - Urodziny
Bitter - Gorzki
Bizarre - Dziwaczny
Black - Czarny
Blackboard - Tablica
Blood - Krew
Blue - Niebieski
Boat - Lodz
Bone - Kosc
Book - Ksiazka
Book store - Ksiegarnia
Bookcase - Regal
Books - Ksiazki
Borrow from sb - Pozyczac od kogos
Boss - Szef
Box office - Kasa biletowa
Boxing - Boks
Boy - Chlopak
Boy scout - Harcerz
Boyfriend - Chlopak
Bra - Biustonosz
Brag - Przechwalac sie
Brain - Mozg
Breakfast - Sniadanie
Breast - Piers
Bride - Panna mloda
Bridegroom - Pan mlody
Bridge - Most
Brigade - Brygada
Bring - Przynosic
Broken - Zepsuty
Broom - Miotla
Brother - Brat
Brother-in-law - Szwagier
Brown - Brazowy
Browse - Przegladac
Brutal - Brutalny
Buddy - Kumpel
Budger - Planowac wydatki
Budget - Budzet
Buffet - Buffet
Building - Budowa
Building - Budynek
Bulb - Zarowka
Bull - Byk
Bullet - Kula
Bulletin - Biuletyn
Bum - Wloczega
Bumper - Zderzak
Bumpy - Wyboisty
Burning - Plonacy
Bus - Autobus
Business card - Wizyt?wka
Business - Biznes
Busy - Zajety
Butter - Maslo
Buttocks - Posladki
Button - Guzik
Buy - Kupowac
Buyer - Kupujacy
Cable TV - Telewizja kablowa
Cake - Ciasto
Calculator - Kalkulator
Calendar - Kalendarz
Call - Dzwonic
Camille - Kamila
Camillus - Kamil
Canal - Kanal
Cancer - Rak
Cancer - Rak
Candidate - Kandydat
Candies - Slodycze
Capricious - Kaprysny
Capricorn - Koziorozec
Captain - Kapitan
Car - Samochood
Cardboard - Tektura
Care - Opieka
Career - Kariera
Careful - Ostrozny
Carnival - Karnawal
Carpet - Dywan
Cartoon - Kreskowka
Casino - Kasyno
Cat - Kot
Catholic - Katolicki
Cause - Pow?d
Ceiling - Sufit
Center - Centrum
Ceramics - Ceramika
Ceremony - Ceremonia
Chairman - Przewodniczacy
Chalk - Kreda
Champagne - Szampan
Change - Zmiana
Change - Zmieniac
Charming - Uroczy
Chat - Rozmawiac
Cheap - Tani
Cheat - Oszukiwac
Cheater - Oszust
Check - Czek
Cheese - Ser
Chess - Szachy
Chest - Klatka piersiowa
Chestnut - Kasztan
Chew - Zuc
Chick - Laska
Chicken - Kurczak
Chicken soup - Rosol
Child - Dziecko
Children - Dzieci
Chimney - Komin
Chocolate - Czekolada
Christina - Krystyna
Christmas - Swieta Bozego Narodzenia
Christopher - Krzysztof
Citron - Cytryna
City - Miasto
Claim form - Podanie
Clench - Zaciskac
Clergy - Kler
Clerk - Urzednik
Clever - Sprytny
Client - Klient
Clock - Zegar
Close - Zamkniety
Close - Zamykac
Clown - Klown
Clumsy - Niezdarny
Coal - Wegiel
Coat - Plaszcz
Cocaine - Kokaina
Coffee - Kawa
Coin - Moneta
Colleague - Kolega z pracy
Collect - Kolekcjonowac
Color - Kolor
Come back - Wr?c
Commemorate - Upamietniac
Commemoration - Obchody
Commentary - Komentarz
Commercial - Reklama
Communion - Komunia
Community - Gmina
Company - Firma
Compare - Porownywac
Comparison - Porownanie
Compassion - Wspolczucie
Compassionate - Wspolczujacy
Compensation - Odszkodowanie
Complain - Narzekac
Complaint - Reklamacja
Composition - Wypracowanie
Compound - Zwiazek
Computer - Komputer
Concert - Koncert
Concrete - Beton
Condolences - Kondolencje
Confidential - Poufny
Confirmation - Bierzmowanie
Conjugal - Malzenski
Connect - Laczyc
Construction - Konstrukcja
Consumption - Konsumpcja
Contain - Zawierac
Container - Pojemnik
Cooking - Gotowanie
Copy - Kopia
Copy - Kopiowac
County - Wies
Cow - Krowa
Crab - Krab
Cracow - Krakow
Cradle - Kolyska
Cramp - Skurcz
Crane - Dzwig
Crazy - Szalony
Cream - smietana
Create - Tworzyc
Credit - Kredyt
Credit - Kredytowac
Crew - Zaloga
Crime - Przestepstwo
Critical - Krytyczny
Crow - Wrona
Crown - Korona
Cruel - Okrutny
Cruise - Rejs
Crust - Skorka
Crusty - Chrupiacy
Cry - Plakac
Crystal - Krysztal
Cube - Kostka
Culture - Kultura
Currency - Waluta
Curriculum vitae - Zyciorys
Curse - Klac
Curtain - Kurtyna
Curve - Luk
Customer - Klient
Customs - Odprawa celna
Cynical - Cyniczny
Dad - Tato
Danger - Niebezpieczenstwo
Dangerous - Niebezpieczny
Dark - Ciemny
Data - Dane
Database - Baza danych
Date - Randka
Date - Data
Day - Dzien
Day - Dzien
Dead - Zmarly
Deal - Zgoda
Debate - Debata
Debit - Debet
Debt - Dlug
Decade - Dekada
Deceive - Oszukiwac
December - Grudzien
Decide - Decydowac
Decision - Decyzja
Define - Okreslac
Delegate - Delegat
Delicious - Wysmienity
Delight - Zachwyt
Delightful - Zachwycajacy
Deliver - Dostarczac
Demand - Zadanie
Demand - Wymagac
Democracy - Demokracja
Dentist - Dentysta
Depression - Depresja
Dermatology - Dermatologia
Dictatorship - Dyktatura
Dictionary - Slownik
Difficult - Trudny
Digit - Cyfra
Dining room - Jadalnia
Dinner - Obiad
Dirty - Brudny
Disagree - Nie zgadzac sie
Disappointment - Rozczarowanie
Disapproval - Dezaprobata
Disarming - Rozbrajajacy
Disaster - Nieszczescie
Disc - Dysk
Discovery - Odkrycie
Dispatch - Wysylac
Display - Wyswietlac
Disposal - Usuwanie
Distinctive - Wyrozniajacy
Distinguish - Odrozniac
Distract - Rozpraszac
Disturb - Przeszkadzac
Divide - Dzielic
Do you speak English - Czy mowisz po angielsku
Doctor - Lekarz
Dog - Pies
Dollar - Dolar
Domain - Domena
Domestic - Krajowy
Dominic - Dominik
Dormitory - Akademik
Dorothy - Dorota
Dose - Dawka
Dot - Kropka
Double - Podw?jny
Downstairs - Na dole
Draw - Remis
Dream - Sen
Dream - Snic
Dress - Sukienka
Dress - Ubierac sie
Dresser - Komoda
Dressing - Sos
Drink - Drink
Drink - Pic
Drive - Kierowac
Drug - Lekarstwo
Drunkard - Pijak
Dry - Suchy
Dry - Schnac
Dryer - Suszarka
Due date - Czas wykonania
Dusk - Zmierzch
Dye - Barwnik
Dye - Farbowac
Dying - Umierajacy
Dynasty - Dynastia  
Eagle - Orzel
Earthquake - Trzesienie ziemi
East - Wschod
Easter - Wielkanocny
Easter - Wielkanoc
Easy - Latwy
Eat - Jesc
Economic - Gospodarczy
Economy - Gospodarka
Edith - Edyta
Education - Edukacja
Eight - Osiem
Eighteen - Osiemnascie
Eighty - Osiemdziesiat
Elementary school - Szkola podstawowa
Eleven - Jedenascie
Embassy - Ambasada
Emerge - Pojawiac sie
Employed - Zatrudniony
Employee - Pracownik
Employer - Pracodawca
Employment - Zatrudnienie
Enable - Umozliwiac
Encyclopedia - Encyclopedia
End - Koniec
End - Konczyc
Endanger - Zagrazac
Endanger - Zagrazac
Energy - Energia
English Writing Style - Styl pisania angielskiego
Enough - Dosc
Entertainment - Rozrywka
Equipment - Sprzet
Equitable - Sprawiedliwy
Equivalent - Rownoznaczny
Research Essay - Wypracowanie na zlecenie
Europe - Europa
Euthanasia - Eutanazja
Eva - Ewa
Evacuate - Ewakuowac
Evacuation - Ewakuacja
Evaluate - Oceniac
Everybody - Wszyscy
Example - Przyklad
Exceed - Przekraczac
Excellent - Doskonaly
Except for - Oprocz
Excerpt - Ustep
Exciting - Pasjonujacy
Exhibit - Wystawiac
Exhibition - Wystawa
Expedition - Wyprawa
Expire - Wygasac
Explanation - Objasnienie
Extra time - Dogrywka
Extreme - Ekstremalny
Face - Twarz
Fact - Fakt
Falcon - Sokol
False - Falszywy
Falsify - Falszowac
Family - Rodzina
Fantastic - Fantastyczny
Farm - Gospodarstwo
Farmer - Gospodarz
Fart - Pierdziec
Farther - Dalej
Fascinating - Fascynujacy
Fast - Szybki
Fasten - Zapinac
Fat - Grubby
Fate - Los
Father - Ojciec
Father-in-law - Tesc
Fatigue - Zmeczenie
Favorite - Ulubiony
Fear - Starch
Fearful - Bojazliwy
Fearless - Nieustraszony
Feather - Pioro
Feature - Cecha
February - Luty
Fee - Oplata
Feed - Karmic
Feel - Czuc
Feeling - Uczucie
Feet - Stopy
Felony - Ciezkie przestepstwo
Fence - Plot
Fencing - Szermierka
Ferry - Prom
Festival - Festiwal
Fidelity - Wiernosc
Fiend - Potwor
Fifteen - Pietnascie
Fifty - Piecdziesiat
Fight - Walka
Fight - Walczyc
Fighter - Wojownik
Figure - Figura
File - Plik
Final - Koncowy
Final - Final
Finally - W koncu
Find out - Dowiedziec sie
Fine arts - Sztuki piekne
Finger - Palec
Fingernail - Paznokiec
Fire - Ogien
Fire - Palic sie
First - Pierwszy
First-rate - Pierwszorzedny
Fish - Ryba
Fishing rod - Wedka
Five - Piec
Fix - Naprawic
Flabby - Sflaczaly
Flag - Flaga
Flagrant - Razacy
Flaw - Skaza
Flawless - Nieskazitelny
Flea - Pchla
Fleet - Flota
Flexibility - Gietkosc
Flicker - Migotac
Flood - Pow?dz
Floor - Podloga
Flower - Kwiatek
Fluffy - Puszysty
Flush - Wypieki
Fly - Latac
Flying - Latanie
Foam - Piana
Foe - Wr?g
Fog - Mgla
Foggy - Mglisty
Foil - Folia
Folk - Ludzie
Food - Jedzenie
Foods - Zywnosc
Fool - Glupiec
Football - Futbol
Footnote - Przypis
Footprint - Odcisk
Foreign - Zagraniczny
Foreigner - Obcokrajowiec
Forever - Na zawsze
Forget - Zapominac
Forgive - Wybaczac
Formal - Formalny
Formal - Uroczysty
Forthright - Otwarty
Fortune - Powodzenie
Forty - Czterdziesci
Forum - Forum
Fossil - Skamielina
Fossil - Skamielina
Four - Cztery
Fourteen - Czternascie
Fox - Lis
France - Francja
Fraud - Oszustwo
Fraudulent - Oszukanczy
Free - Wolny
Free will - Wolna wola
Freedom - Wolnosc
Freelance - Niezalezny
Freeze - Mrozic
Freezing - Lodowaty
French - Francuski
Friday - Piatek
Friend - Przyjaciel
Frog - Zaba
Frogman - Pletwonurek
Front page - Strona tytulowa
Frying pan - Patelnia
Fulfill - Wypelnic
Full - Pelny
Fun - Zabawa
Funeral - Pogrzeb
Furniture - Meble
Gamble - Ryzykowac
Gamble - Ryzyko
Garage - Warsztat
Garage - Garaz
Garbage - Pojemnik na smieci
Garden - Ogrod
Garlic - Czosnek
Gas - Paliwo
Gearbox - Skrzynia biegow
Gel - Zel
Gem - Klejnot
Gemini - Bliznieta
Gene - Gen
Genealogical - Genealogiczny
Genealogy - Genealogia
General - General
Generation - Pokolenie
Generous - Szczodry
Gentleman - Pan
Genuine - Prawdziwy
Geography - Geografia
Geology - Geologia
George - Jerzy
German - Niemiecki
Germany - Niemcy
Gesticulation - Gestykulacja
Gesture - Gest
Get enough sleep - Wysypiac sie
Get out - Wynos sie
Get together - Spotkac sie
Get up - Wstawac
Ghetto - Getto
Giant - Gigantyczny
Giant - Gigant
Gift - Prezent
Girl - Dziewczyna
Girlfriend - Dziewczyna
Glass - Szklo
Glasses - Okulary
Goalkeeper - Bramkarz
Goat - Koza
God - Bog
Gold - Zloto
Golden - Zloty
Good luck - Powodzenia
Good night - Dobranoc
Goodbye - Do widzenia
Grandfather - Dziadek
Grandmother - Babcia
Grapes - Winogrona
Graphics - Grafika
Grasp - Chwytac
Grass - Trawa
Gravity - Grawitacja
Greasy - Przetluszczony
Great - Wspanialy
Great Britain - Wielka Brytania
Great-grandfather - Pradziadek
Great-grandmother - Prababcia
Greatness - Wielkosc
Grecian - Grecki
Greece - Grecja
Greed - Chciwosc
Green - Zielony
Greet - Pozdrawiac
Greetings - Pozdrowienia
Gregory - Grzegorz
Grey - Szary
Growth - Wzrost
Guardian - Opiekun
Guest - Gosc
Guide - Przewodnik
Guide - Prowadzic
Gunshot - Wystrzal
Hair - Wlosy
Hallo - Halo
Ham - Szynka
Hammer - Mlot
Hands - Rece
Hang up - Odlozyc sluchawke
Happiness - Szczescie
Happy - Szczesliwy
Happy birthday - Wszystkiego najlepszego z okazji urodzin
Happy New Year - Szczesliwego Nowego Roku
Harass - Nekac
Harassment - Nekanie
Harbor - Port
Have a nice day - Przyjemnego dnia
Have a nice weekend - Udanego weekendu
Have fun - Bawcie sie
Hawaii - Hawaje
Hawk - Jastrzab
Hawker - Domokrazca
Hay - Siano
He - On
Headache - Bol glowy
Heading - Naglowek
Heal - Leczyc
Healthy - Zdrowy
Heap - Stos
Hear - Slyszec
Hearing - Rozprawa
Heart attack - Atak serca
Heart - Serce
Hearty - Serdeczny
Heater - Grzejnik
Heavy - Ciezki
Height - Wysokosc
Hello - Witam
Help - Pomoc
Help - Pomoc
Helpless - Bezradny
Henry - Henryk
Her - Jej
Herb - Ziolo
Hermit - Pustelnik
Hero - Bohater
Heroism - Bohaterstwo
Hi - Czesc
Hi, how are you - Hej, jak sie masz
Hidden - Ukryty
Hide - Ukrywac
Highlander - G?ral
High-school - Liceum
Highway - Autostrada
Hijack - Porywac
Hike - Piesza wycieczka
Hiker - Turysta
Hillside - Stok
Hirer - Zatrudnic
His - Jego
Hiss - Syczenie
History - Historia
Hit - Uderzac
Hold - Trzymac
Hole - Dziura
Hole - Dziurawic
Holiday - Wakacje
Holocaust - Zaglada
Holy - Swiety
Home - Dom
Homework - Praca domowa
Homicide - Zabojstwo
Hook - Hak
Hooligan - Chuligan
Hope - Nadzieja
Hope - Miec nadzieje
Horse - Kon
Hospitable - Goscinny
Hostel - Schronisko
Hotel - Hotel
Hour - Godzina
Human - Ludzki
Hunch - Przeczucie
Hundred - Sto
Hunt - Polowac
Hunter - Mysliwy
Hurricane - Huragan
Husband - Maz
Hysterical - Histeryczny
I don’t know - Nie wiem
I don’t understand - Nie rozumiem
I hate you - Nienawidze Cie
I love you - Kocham Cie
I miss you - Tesknie za Toba
I - Ja
I will do it - Zrobie to
Ill - Chory
Imagination - Wyobraznia
Imagine - Wyobrazac
Immediate - Natychmiastowy
Immigrant - Immigrant
Immigration - Imigracja
Immodest - Nieskromny
Immoral - Niemoralny
Imperfect - Wadliwy
In - Wewnatrz
Inaccessible - Niedostepny
Inactive - Nieczynny
Inaudible - Nieslyszalny
Inborn - Wrodzony
Incapable - Nieporadny
Incest - Kazirodztwo
Incident - Wydarzenie
Indeed - Istotnie
Indefinite - Niejasny
Industry - Przemysl
Inexact - Niedokladny
Inexpensive - Niedrogi
Inexperience - Brak doswiadczenia
Information - Informacja
Infringe - Naruszac
Ingenious - Pomyslowy
Inhabitant - Mieszkaniec
Initiate - Zapoczatkowac
Insensitive - Nieczuly
Insensitivity - Nieczulosc
Insert - Wkladac
Insertion - Wlozenie
Inside - Wnetrze
Intense - Natezony
Interesting - Ciekawy
International - Miedzynarodowy
Internet - Internet
Interrupt - Przerywac
Interval - Przerwa
Introduce - Przedstawic
Introduction - Przedstawienie
Intuition - Intuicja
Invalid - Niewazny
Invention - Wynalazek
Investigate - Badac
Invitation - Zaproszenie
Invite - Zapraszac
Invoice - Rachunek
Involve - Wymagac
Irene - Irena
Irony - Ironia
Island - Wyspa
It - To
Italian - Wloski
Italics - Kursywa
Italy - Wlochy
Itch - Swedzacy
Item - Rzecz
Jack - Jacek
Jackass - Osiol
Jacket - Marynarka
Jacket - Zakiet
Jackpot - Glowna wygrana
Jacob - Kuba
Jail - Wiezienie
January - Styczen
Jargon - Zargon
Jealous - Zazdrosny
Jeans - Dzinsy
Jelly - Galaretka
Jerk - Palant
Jet - Odrzutowiec
Jew - Zyd
Jewel - Klejnot
Jewelry - Bizuteria
Jewish - Zydowski
Job - Praca
John - Jan
Join - Dolaczyc
Joke - Kawal
Joseph - Jozef
Joy - Radosc
Judicial - Sadowy
Juice - Sok
Juicy - Soczysty
Jukebox - Szafa grajaca
July - Lipiec
Jump suit - Kombinezon
Jump - Skakac
June - Czerwiec
Jungle - Dzungla
Just - Sprawiedliwy
Justice - Sprawiedliwosc
Justine - Justyna
Kaleidoscope - Kalejdoskop
Kangaroo - Kangur
Kayak - Kajak
Keen - Zapalony
Keep - Zatrzymywac
Keeper - Str?z
Kennel - Buda dla psa
Kettle - Czajnik
Key - Klucz
Keyboard - Klawiatura
Keys - Klucze
Kid - Dziecko
Kidnap - Porywac
Kidney - Nerka
Kids - Dzieci
Kill - Zabijac
Kindness - Uprzejmosc
King - Kr?l
Kinky - Zboczony
Kinship - Pokrewienstwo
Kiss - Pocalunek
Kiss - Calowac
Kite - Latawiec
Knee - Kolano
Knife - Noz
Knight - Rycerz
Knit - Robic na drutach
Knock - Uderzac
Knock down - Powalic
Kosher - Koszerny
Labyrinth - Labirynt
Lack - Brak
Lady - Pani
Lake - Jezioro
Lame - Kiepski
Lamp - Lampa
Land - Ziemia
Landlord - Wlasciciel
Language - Jezyk
Lark - Skowronek
Last - Ostatni
Lasting - Trwaly
Lastly - Na koniec
Late - Sp?zniony
Latecomer - Spoznialski
Lately - Ostatnio
Laugh - Smiech
Laugh - Smiac sie
Law - Prawo
Lawn - Trawnik
Lawnmower - Kosiarka do trawy
Lawyer - Prawnik
Lay off - Zwalniac z pracy
Layer - Warstwa
Lead - Ol?w
Leade - Przyw?dca
Leaf - Lisc
Lean - Chude
Learn - Uczyc sie
Learning - Wiedza
Leather - Sk?rzany
Leather - Sk?ra
Leave - Opuszczac
Leaves - Liscie
Lecture - Wyklad
Lecturer - Wykladowca
Leech - Pijawka
Legal - Legalny
Legal advisor - Radca prawny
Legend - Legenda
Legibility - Czytelnosc
Legible - Czytelny
Lemon - Cytryna
Lemon tea - Herbata cytrynowa
Lend it to me - Pozycz mi to
Lend sb sth - Pozyczyc cos komus
Lender - Pozyczkodawca
Length - Dlugosc
Lent - Wielki post
Leo - Lew
Lesson - Lekcja
Letdown - Zaw?d
Lethal - Smiercionosny
Letter - Litera
Letter - List
Lettuce - Salata
Liar - Klamca
Libra - Waga
Lie - Klamstwo
Lie - Klamac
Life - Zycie
Life style - Styl zycia
Light - Lekki
Light - Swiatlo
Like - Lubic
Lips - Usta
Liquid - Plynny
Liquid - Plyn
Listen - Sluchac
Litter - Smieci
Live - Zyc
Livestock - Zywy inwentarz
Load - Ladunek
Loan - Pozyczka
Lonely - Samotny
Lose - Tracic
Love affair - Romans
Love - Kochac
Loyal - Lojalny
Lubricate - Smarowac
Lucrative - Intratny
Ludwig - Ludwik
Luggage - Bagaz
Lukewarm - Letni
Lydia - Lidia 
Magdalene - Magdalena
Magic - Magia
Maid - Sluzaca
Mailbox - Skrzynka pocztowa
Maintenance - Utrzymanie
Major - Wazny
Make love - Kochac sie
Maker - Producent
Make-up - Makijaz
Malice - Zlosliwosc
Malignant - Zlosliwy
Man - Mezczyzna
Many - Duzo
Map - Mapa
March - Marzec
Margaret - Malgorzata
Maria - Maria
Martial - Wojskowy
Mark - Marek
Martha - Marta
Martin - Marcin
Math - Matematyka
Matthew - Mateusz
Maxim - Maksyma
Maximum - Maksymalny
Maximum - Maksimum
May - Maj
Me - Mnie
Measure - Miara
Measure - Mierzyc
Meat - Mieso
Medical - Medyczny
Meditation - Medytacja
Meeting - Spotkanie
Mellow - Lagodny
Melody - Melodia
Member - Czlonek
Memory - Pamiec
Mention - Wspominac
Merciful - Milosierny
Merry Christmas - Wesolych Swiat
Mew - Miauczec
Mice - Myszy
Michael - Michal
Mighty - Potezny
Mild - Lagodny
Milk - Mleko
Million - Million
Mind - Umysl
Mine - Moj
Minimum - Minimalny
Minimum - Minimum
Mint - Mieta
Minute - Minuta
Mirror - Lustro
Mistake - Blad
Mistake - Popelnic blad
Mistress - Kochanka
Misuse - Naduzywanie
Mixed - Mieszany
Mobilize - Mobilizowac
Model - Modelka
Model - Model
Monday - Poniedzialek
Money - Pieniadze
Monica - Monika
Monitor - Monitor
Month - Miesiac
More - Wiecej
Moron - Debil
Mortal - Smiertelny
Mortify - Zawstydzac
Mother - Matka
Mother-in-law - Tesciowa
Motherland - Kraj ojczysty
Mountains - Gory
Mouse - Mysza
Movie - Film
Much - Duzo
Multiply - Mnozyc
Mum - Mama
Mundane - Przyziemny
Murder - Morderstwo
Muscle - Miesien
Muscles - Muskuly
Museum - Museum
Mushrooms - Grzyby
Music - Muzyka
Must - Musiec
Musty - Stechly
Mystery - Tajemnica 
Nail - Paznokiec
Nail - Gw?zdz
Name - Imie
Name - Nazywac
Nap - Drzemka
Napkin - Serwetka
Narrate - Opowiadac
Narrow - Waski
Natalie - Natalia
National - Narodowosciowy
Naughty - Niegrzeczny
Nausea - Mdlosci
Nautical - Zeglarski
Naval - Morski
Necessary - Konieczny
Necessary - Potrzebny
Neck - Szyja
Need - Potrzebowac
Never - Nigdy
News - Wiadomosci
Newspaper - Gazeta
Nice - Ladny
Nicolas - Mikolaj
Night - Noc
Nightclub - Klub nocny
Nightlife - Nocne zycie
Nightmare - Koszmar
Nine - Dziewiec
Nineteen - Dziewietnascie
Ninety - Dziewiecdziesiat
Nipples - Sutki
Nobody - Nikt
North - Polnoc
Not - Nie
Not far away - Niedaleko
Notary - Notariusz
Nothing - Nic
Noun - Rzeczownik
November - Listopad
Nudge - Szturchac
Nudist - Nudysta
Nurse - Pielegniarka 
Oak - Debowy
Oak - Dab
Obedient - Posluszny
Obscenity - Nieprzyzwoitosc
Observation - Obserwacja
Observe - Obserwowac
Obvious - Oczywisty
Occasion - Okazja
Ocean - Ocean
October - Pazdziernik
Odd - Nieparzysty
Odd - Dziwny
Office - Biuro
Office worker - Urzednik
Officer - Officer
Officially - Oficjalnie
Often - Czesto
Okay - Dobrze
Old - Stary
Olympic Games - Igrzyska
On purpose - Celowo
One - Jeden
Onion - Cebula
Open - Otwarty
Open - Otwierac
Opinion - Opinia
Opportunity - Okazja
Oracle - Wyrocznia
Oral - Ustny
Orange - Pomaranczowy
Orange - Pomarancza
Orchard - Sad
Orchestra - Orkiestra
Order - Zamawiac
Order - Porzadek
Organism - Organism.
Organize - Organizowac
Original - Oryginalny
Orphan - Sierota
Our - Nasz
Ours - Nasz
Out - Na zewnatrz
Outcast - Wyrzutek
Overdue - Zalegly
Overflow - Wylewac
Overrate - Przeceniac
Oversleep - Zaspac
Overworked - Przepracowany
Ovulation - Owulacja
Owl - Sowa
Oxygen - Tlen 
Pack - Paczka
Pack - Pakowac
Page - Kartka
Paint - Farba
Paint - Malowac
Palace - Palac
Pancake - Nalesnik
Pane - Szyba
Pants - Spodnie
Parcel - Paczka
Partial - Czesciowy
Passionate - Namietny
Passive - Bierny
Passport - Passport
Password - Haslo
Pasta - Makaron
Pastime - Hobby
Patrick - Patryk
Paul - Pawel
Pauline - Paulina
Pay - Placic
Payment - Platnosc
Peace - Pok?j
Pear - Gruszka
Pencil - Ol?wek
Penis - Czlonek
People - Ludzie
Person - Osoba
Personal - Osobisty
Personal details - Dane osobowe
Persuade - Przekonywac
Peter - Piotr
Pharmacy - Apteka
Phew - Uff
Philip - Filip
Phone book - Ksiazka telefoniczna
Phone call - Rozmowa telefoniczna
Phone card - Karta telefoniczna
Phone - Telefon
Phone - Dzwonic
Photo - Zdjecie
Photocopier - Fotokopiarka
Photographer - Fotograf
Photos - Zdjecia
Physician - Lekarz
Piano - Fortepian
Picnic - Piknik
Pigeon - Golab
Pike - Szczupak
Pill - Pigulka
Pillow - Poduszka
Pilot - Pilot
Pimp - Alfons
Pimple - Pryszcz
Pinch - Szczypta
Pink - Rozowy
Pirate - Pirat
Pisces - Ryby
Piss - Sikac
Pistol - Pistolet
Pitfall - Pulapka
Pitiful - Zalosny
Pizza - Pizza
Plane - Samolot
Plant - Roslina
Plant - Sadzic
Plastic - Plastikowy
Plastic - Plastik
Player - Odtwarzacz
Player - Gracz
Pleasant - Przyjemny
Please - Prosze
Pleasure - Przyjemnosc
Plum - Sliwka
Poem - Wiersz
Poet - Poeta
Pointless - Bezcelowy
Poison - Trucizna
Poland - Polska
Poles - Polacy
Police - Policja
Policy - Polityka
Polite - Mily
Pond - Staw
Poor - Biedny
Pope - Papiez
Pork - Wieprzowina
Pornography - Pornografia
Post office - Poczta
Postcard - Poczt?wka
Poster - Plakat
Postman - Listonosz
Potato - Ziemniak
Pottery - Garncarstwo
Prawn - Krewetka
Preach - Wyglaszac kazanie
Precaution - Zabezpieczenie
Precede - Poprzedzac
Premature - Przedwczesny
Prepared - Gotowy
Preposition - Przyimek
Prescription - Recepta
Present - Present
Present - Obecny
President - Prezydent
Press agency - Agenja prasowa
Press - Prasa
Pressure - Cisnienie
Prestige - Prestiz
Previous - Poprzedni
Price - Cena
Priceless - Bezcenny
Prick - Kutas
Priest - Ksiadz
Prime - Pierwszorzedny
Prime Minister - Premier
Primitive - Prymitywny
Princess - Ksiezniczka
Principle - Zasada
Printer - Drukarka
Priority - Sprawa najwazniejsza
Prison - Wiezienie
Private - Prywatny
Problem - Klopot
Procedural - Formalny
Process of Writing - Process pisania
Pronounce - Wymawiac
Pronunciation - Wymowa
Property - Majatek
Prophet - Prorok
Proposal - Oswiadczyny
Protein - Bialko
Proud - Dumny
Prove - Udawadniac
Public - Publiczny
Publish - Publikowac
Publisher - Wydawca
Punctual - Punktualny
Punctuality - Punktualnosc
Punish - Karac
Purple - Fioletowy
Purpose - Cel
Purse - Torebka
Push - Pchac 
Quake - Trzasc sie
Qualification - Kwalifikacje
Qualify - Kwalifikowac sie
Quality - Jakosc
Qualm - Niepokoj
Quantity - Ilosc
Quarrel - Klotnia
Quarrel - Klocic sie
Quarter - Cwierc
Quarterfinal - Cwiercfinal
Queen - Kr?lowa
Quest - Poszukiwanie
Question mark - Znak zapytania
Question - Pytanie
Questionable - Watpliwy
Queue - Kolejka
Quick - Szybki
Quickly - Szybko
Quiet - Cichy
Quietly - Cicho
Quit - Rezygnowac
Quite - Calkiem
Quotation - Cytat
Quote - Cytowac
Quotient - wspolczynnik 
Rabies - Wscieklizna
Race - Wyscig
Racing car - Samochod wyscigowy
Radiation - Promieniowanie
Radiator - Kaloryfer
Radiato - Chlodnica
Radio - Radio
Rain - Deszcz
Rain - Padac
Random - Przypadkowy
Random - Losowy
Raphael - Rafal
Raw material - Surowiec
Razor - Golarka
React - Reagowac
Reaction - Reakcja
Real estate - Nieruchomosc
Reasonable - Rozsadny
Receiver - Sluchawka
Recipe - Przepis
Recognize - Rozpoznawac
Record - Zapis, Spis
Rectangle - Prostokat
Red - Czerwony
Reform - Reforma
Reform - Reformowac
Refrigerator - Lodowka
Refund - Zwrot pieniedzy
Refund - Zwracac pieniadze
Refusal - Odmowa
Refuse - Odmawiac
Relevant - Istotny
Reliable - Solidny
Reluctant - Niechetny
Remember - Pamietac
Rent - Wynajmowac
Rent - Wypozyczac
Rent - Czynsz
Repeat - Powtarzac
Repetition - Powtorka
Request - Prosba
Request - Prosic
Required - Wymagany
Reservation - Rezerwacja
Reserve - Zapas
Reserved - Zarezerwowany
Respect - Powazanie
Respect - Szanowac
Rest room - Toaleta
Rest - Odpoczywac
Resume - Wznowic
Retail - Detaliczny
Retail price - Cena detaliczna
Rethink - Przemyslec
Rib - Zebro
Ribbon - Wstazka
Rich - Bogaty
Richard - Ryszard
Rider - Jezdziec
Ridiculous - Smieszny
Riot - Rozruchy
Rip - Rozdarcie
Rip off - zdzierac
Ripe - Dojrzaly
Rising - Rosnacy
Risk - Ryzyko
Risk - Ryzykowac
Risky - Ryzykowny
River - Rzeka
Road - Droga
Road sign - Znak drogowy
Roast - Pieczony
Roast - Pieczen
Roast - Piec
Robber - Rabus
Robert - Robert
Rock climbing - Wspinaczka
Rocket - Rakieta
Role - Rola
Roll - Rolka
Roman - Rzymski
Roof - Dach
Room - Pokoj
Round - Okragly
Rowdy - Awanturniczy
Rubbish - Brednie
Rude - Nieuprzejmy
Ruler - Linijka
Rumor - Pogloska
Run away - Uciekac
Runaway - Zbieg
Runner - Biegacz
Running - Bieganie
Run-off - Dogrywka
Run-off - Druga tura
Runway - Pas startowy
Russian - Rosyjski
Rust - Rdza 
Safe - Bezpieczny
Sagittarius - Strzelec
Salad - Salatka
Sand - Piasek
Sandal - Sandal
Satellite - Satelita
Saturday - Sobota
Sausage - Kielbasa
Save - Nagrywac
Save - Ratowac
Say - Mowic
Say yes - Przytakiwac
Saying - Powiedzenie
Scale - Waga
Schedule - Rozklad
Scholar - Naukowiec
School - Szkola
Scissors - Nozyczki
Scooter - Skuter
Score - Wynik
Scorpio - Scorpion
Screen saver - Wygaszacz ekranu
Search engine - Przeszukiwarka
Seaside - Wybrzeze morskie
Seasonal - Sezonowy
Seasons of the year - Pory roku
Second - Sekunda
Second - Drugi
Secretive - Tajemniczy
Section - Odcinek
Secure - Bezpieczny
See you tomorrow - Do zobaczenia jutro
Seldom - Rzadko
Sell - Sprzedawac
Seller - Sprzedawca
Send - Wysylac
Separate - Rozdzielac
Separation - Sepracja
September - Wrzesien
Sequence - Kolejnosc
Serve - Sluzyc
Service - Usluga
Set up - Zakladac
Setup - Uklad
Seven - Siedem
Seventeen - Siedemnascie
Seventy - Siedemdziesiat
Shadow - Cien
Shampoo - Szmpon
She - Ona
Shine - Swiecic
Ship - Statek
Shipment - Przesylka
Shirt - Koszula
Shiver - Trzasc sie
Shock - Szok
Shock - Szokowac
Shoes - Buty
Shooting - Strzelanina
Shopping mall - Centrum handlowe
Shopping - Zakupy
Short - Niski
Show the door - Wypraszac za drzwi
Shy - Niesmialy
Shyness - Niesmialosc
Sick - Chory
Sign - Znak
Silver - Srebro
Simon - Szymon
Simple - Prosty
Sin - Grzech
Sin - Grzeszyc
Sincere - Szczery
Sincerely - Z powazaniem
Sing - Spiewac
Single - Pojedynczy
Single - Niezamezny
Single - Niezamezna
Sister - Siostra
Sit - Siadacac
Situation - Sytuacja
Six - Szesc
Sixteen - Szesnascie
Sixty - Szescdziesiat
Size - Rozmiar
Skate - Jezdzic na lyzwach
Skating - Lyzwiarstwo
Sky - Niebo
Sleep - Spac
Sloppy - Niechlujny
Slouch - Garbic sie
Slum - Slumsy
Small - Pachniec
Smell - Zapach
Soap - Mydlo
Soccer - Pilka nozna
Sofa - Kanapa
Soil - Gleba
Soldier - Zolniez
Somebody - Ktos
Song - Piosenka
Sophie - Zofia
Sorrow - Smutek
South - Poludnie
Spade - Lopata
Spark - Iskra
Sparrow - Wrobel
Spear - Dzida
Speculator - Spekulant
Speech - Przemowa
Sleepy - Spiacy
Spelling - Pisownia
Sphere - Kula
Spine - Kregoslup
Spirit - Duch
Spiritual - Duchowy
Sport - Sport
Spot - Miejsce
Spot - Zauwazyc
Spring - Wiosna
Spruce - Swierk
Spy - Szpieg
Square - Kwadrat
Stabilize - Stabilizowac
Stamp - Znaczek
Stanley - Stanislaw
Star - Gwiazda
Steel - Stal
Stephen - Stefan
Stock exchange - Gielda
Stomach - Brzuch
Stomachache - Bol brzucha
Store - Sklep
Storm - Burza
Stove - Piec
Street - Ulica
Student - Student
Studious - Pilny
Stupid - Glupi
Subscribe - Zapisac sie
Subscription - Subskrypcja
Sue - Skarzyc
Suffer - Cierpiec
Summarize - Streszczac
Summary - Streszczenie
Summer - Lato
Sunday - Niedziela
Sunflower - Slonecznik
Sunrise - Wschod slonca
Sunset - Zachod slonca
Supper - Kolacja
Surname - Nazwisko
Swallow - Lykac
Swelling - Opuchlizna
Swim - Plywac
Sylvia - Sylwia 
Table - Tabela
Take a shower - Wziac prysznic
Take over - Przejmowac
Talk - Rozmowa
Talk over - Omawiac
Talk - Rozmawiac
Tall - Wysoki
Tangible - Namacalny
Taurus - Byk
Taxi driver - Taksowkarz
Tea - Herbata
Teach - Nauczac
Teacher - Nauczyciel
Teeth - Zeby
Telescope - Luneta
Television - Telewizja
Template - Szablon
Ten - Dziesiec
Tennis ball - Pilka tenisowa
Tennis - Tennis
Textbook - Podrecznik
Thank you - Dziekuje
That - Tamto
Theater - Teatr
Theft - Kradziez
Their - Ich
Theirs - Ich
Theme - Temat
Then - Wtedy
Theoretical - Teoretyczny
Theresa - Teresa
They - Oni
Thin - Chuddy
Think up - Wymyslec
Think - Myslec
Third - Trzeci
Thirteen - Trzynascie
Thirty - Trzydziesci
This - To
Thomas - Tomasz
Thoughtful - Przemyslany
Thousand - Tysiac
Threat - Grozba
Threaten - Grozic
Three - Trzy
Thursday - Czwartek
Tight - Obcisly
Time - Czas
Time-consuming - Czasochlonny
Tire - Opona
Tired - Zmeczony
Tissue - Chusteczka
Today - Dzisiaj
Together - Razem
Toilet paper - Papier toaletowy
Tomato - Pomidor
Tomorrow - Jutro
Tongue - Jezyk
Tool - Narzedzie
Tooth - Zab
Toothache - Bol zeba
Toothpaste - Pasta do zebow
Toothpick - Wykalaczka
Top - Szczyt
Topping - Dodatek
Torture - Tortury
Totally - Calkowicie
Touch - Dotyk
Touch - Dotykac
Touchy - Przewrazliwiony
Tough - Wytrzymaly
Tourist office - Biuro turystyczne
Tower - Wieza
Town - Miasto
Toy - Zabawka
Tracksuit - Dres
Tractor - Traktor
Trade - Handel
Trade name - Nazwa handlowa
Tradition - Tradycja
Traditional - Tradycyjny
Traffic jam - Korek uliczny
Traffic - Ruch
Trafficker - Handlarz
Trail - Szlak
Trailer - Naczepa
Train - Pociag
Transit visa - Wiza tranzytowa
Translation - Tlumaczenie
Translator - Tlumacz
Transmit - Transmitowac
Transparent - Przezroczysty
Transplant - Przeszczep
Transplant - Przeszczepiac
Travel - Podr?z
Tray - Taca
Treasure - Skarb
Treat - Uczta
Treat - Traktowac
Tree - Drzewo
Trendy - Modny
Trial - Process
Trial period - Process probny
Triangle - Tr?jkat
Tribe - Plemie
Trick - Sztuczka
Trick - Trik
Tricky - Skomplikowany
Trigger - Spust
Trip - Wycieczka
Triple - Potr?jny
Trooper - Policjant
Truck - Ciezar?wka
True - Prawdziwy
Trust - Zaufanie
Trust - Ufac
Trustful - Ufny
Trustworthy - Godny zaufania
Truth - Prawda
Truthful - Prawdom?wny
Try on - Przymierzac
Try - Pr?bowac
T-shirt - Podkoszulek
Tube - Rurka
Tuesday - Wtorek
Turn it off - Wylacz to
Turn it on - Wlacz to
Turtle - Zolw
Twelve - Dwanascie
Twenty - Dwadziescia
Two - Dwa
Typing - Pisanie na komputerze
Ulcer - Wrzod
Ultimatum - Ultimatum
Umbrella - Parasol
Unacceptable - Niedopuszczalny
Unanimous - Jednomyslny
Unarmed - Nieuzbrojony
Unattractive - Nieatrakcyjny
Unaware - Nieswiadomy
Unbeaten - Niepokonany
Unbelievable - Niewiarygodny
Unchanged - Niezmieniony
Uncle - Wujek
Unclear - Niejasny
Uncomfortable - Niewygodny
Uncommon - Niezwykly
Uncomplicated - Nieskomplikowany
Unconscious - Nieprzytomny
Uncontrolled - Niekontrolowany
Uncover - Odkrywac
Undelivered - Niedostarczony
Under construction - W budowie
Undercover - Tajny
Underline - Podkreslac
Undershirt - Podkoszulek
Undoubtedly - Niewatpliwie
Unique - Unikatowy
Unit - Jednostka
Unmatched - Niezrownany
Unmerciful - Bezlitosny
Unpleasant - Nieprzyjemny
Unworthy - Niewart
Upper - Gorny
Upstairs - Na pietrze
Urge - Pragnienie
Urgent - Pilny
Ursula - Urszula
User - Uzytkownik
Usually - Zwykle
Utility - Uzytecznosc
Utilize - Wykorzystywac 
Vacation - Wakacje
Vacuum cleaner - Odkurzacz
Vain - Prozny
Valentine - Walenty
Valentine - Walentynka
Vast - Rozlegly
Verb - Czasownik
Verify - Sprawdzac
Veronica - Weronika
Very well - Bardzo dobrze
Victor - Wiktor
Victory - Wygrana
View - Widok
Virgin - Dziewica
Virgo - Panna
Virtual - Wirtualny
Visa - Wiza
Visit - Odwiedzac
Vocabulary - Slownictwo
Vodka - Wodka
Vote - Glos
Vote - Glosowac
Vulgar - Wulgarny 
Waiter - Kelner
Waitress - Kelnerka
Wake - Budzic
Want - Chciec
Wanted - Poszukiwany
War - Wojna
Warning - Ostrzezenie
Warranty - Gwarancja
Warsaw - Warszawa
Wash - Myc
Watch a movie - Ogladac film
Water - Woda
Wax - Wosk
Wax - Woskowac
We - My
Weather - Pogoda
Web page - Strona internetowa
Wedding - Wesele
Wednesday - Sroda
Week - Tydzien
Welcome - Witac
Well-kept - Dobrze utrzymany
West - Zachid
What for - Po co
When - Kiedy
Where are you at - Gdzie jestes
Where - Gdzie
Whereas - Podczas gdy
White - Bialy
Who - Kto
Wholesale - Hurt
Wholesaler - Hurtownik
Why - Dlaczego
Widow - Wdowa
Widower - Wdowiec
Width - Szerokosc
Wife - Zona
Willow - Wierzba
Willpower - Sila woli
Wimp - Mieczak
Wind - Wiatr
Window - Okno
Windows - Okna
Wine - Wino
Winter - Zima
Witch - Czarownica
Woman - Kobieta
Wood - Drewno
Work force - Sila robocza
Worker - Pracownik
Worries - Troski
Worry - Martwic sie
Worst - Najgorszy
Worthless - Bezwartosciowy
Yacht - Jacht
Yap - Ujadac
Yard - Podworko
Yawn - Ziewniecie
Yawn - Ziewac
Year - Rok
Yearbook - Rocznik
Yearly - Corocznie
Yearning - Tesknota
Yeast - Drozdze
Yellow - Zolty
Yes - Tak
Yesterday - Wczoraj
Yet - Jeszcze
Yield - Ulegac
Yogurt - jogurt
Yolk - Zoltko
You - Wy
You - Ty
You should do it - Powinienes to zrobic
Young - Mlody
Your - Wasz
Your - Twoj
Yours - Wasz
Youth - Mlodosc
Youthful - Mlodzienczy
Yummy - Pyszny 
Zeal - Zapal
Zealot - Fanatyk
Zealous - Zagorzaly
Zebra - Zebra
Zenith - Zenit
Zero - Zero
Zinc - Cynk
Zip code - Kod pocztowy
Zip - Zamek blyskawiczny
Zodiac - Zodiak
Zone - Strefa
Zoo - Zoo